1111111111111111
1CCCCCCCCCCCCC11
1ECCCCCCCCCCPC11
1111111111111111
