111111
100001
1000P1
0C0E01
11111
