1111111111111111
1000000000000001
1000P00000000001
1010101010101C11
1000000100000001
1010101C10000001
1C00000000000001
1010101010101C11
10000001C0000001
1010101010000001
1E00000000000001
1111111111111111
