11111111
10000001
1000P001
1C000001
100000E1
11111111
