1111111111111111
100000000C000001
1000P00000000C01
1010101010101011
1000000000000001
100000000C000001
1C00000000000001
1000000000000001
100000000000C001
1000000000000001
1010101010101011
1000000000000001
1000000000000001
1E000000000000C1
1111111111111111
