11111111
10000001
1000P001
1C000011
100000E1
11111111
