1111111111111111
1000000000000001
1000P00000000001
1C10101010101C11
100000C100000001
1010101000000001
1C00000000000001
1000000100000001
101010101C101011
1000000100000001
1E00000000000001
1111111111111111
