1111111111111111
100000000000C001
1000P00000000001
1010101010101011
1000000C00000001
1000000100000001
1C00000000000001
1010000000000001
100000010000C001
1100000C00000001
1E00000000000001
1111111111111111
