11111111
100000E1
11111111
1C000001
100P00C1
11111111
