11111111
10000001
10000001
1C000001
100000E1
11111111
